2 2 2 2 2 2 2 2 2 2 2 2 2 2 2 2 2 2 2 2 2 2 2 2 2 2 2 2 2 2
2 X X X 0 0 0 X X X X 0 0 0 X X X X 0 0 0 X X X X 0 0 0 X 2
2 X 3 3 3 3 X 0 0 0 X 3 3 3 3 X 0 0 0 X 3 3 3 3 X 0 0 0 X 2
2 X 3 1 1 3 X 0 0 0 X 3 1 1 3 X 0 0 0 X 3 1 1 3 X 0 0 0 X 2
2 X 3 3 3 3 X 0 0 0 X 3 3 3 3 X 0 0 0 X 3 3 3 3 X 0 0 0 X 2
2 X X X X X X 0 0 0 X X X X X X 0 0 0 X X X X X X 0 0 0 X 2
2 2 2 2 2 2 2 2 2 2 2 2 2 2 2 2 2 2 2 2 2 2 2 2 2 2 2 2 2 2
2 X X X 0 0 0 X X X X 0 0 0 X X X X 0 0 0 X X X X 0 0 0 X 2
2 X 3 3 3 3 X 0 0 0 X 3 3 3 3 X 0 0 0 X 3 3 3 3 X 0 0 0 X 2
2 X 3 1 1 3 X 0 0 0 X 3 1 1 3 X 0 0 0 X 3 1 1 3 X 0 0 0 X 2
2 X 3 3 3 3 X 0 0 0 X 3 3 3 3 X 0 0 0 X 3 3 3 3 X 0 0 0 X 2
2 X X X X X X 0 0 0 X X X X X X 0 0 0 X X X X X X 0 0 0 X 2
2 2 2 2 2 2 2 2 2 2 2 2 2 2 2 2 2 2 2 2 2 2 2 2 2 2 2 2 2 2
2 X X X 0 0 0 X X X X 0 0 0 X X X X 0 0 0 X X X X 0 0 0 X 2
2 X 3 3 3 3 X 0 0 0 X 3 3 3 3 X 0 0 0 X 3 3 3 3 X 0 0 0 X 2
2 X 3 1 1 3 X 0 0 0 X 3 1 1 3 X 0 0 0 X 3 1 1 3 X 0 0 0 X 2
2 X 3 3 3 3 X 0 0 0 X 3 3 3 3 X 0 0 0 X 3 3 3 3 X 0 0 0 X 2
2 X X X X X X 0 0 0 X X X X X X 0 0 0 X X X X X X 0 0 0 X 2
2 2 2 2 2 2 2 2 2 2 2 2 2 2 2 2 2 2 2 2 2 2 2 2 2 2 2 2 2 2
2 2 2 2 2 2 2 2 2 2 2 2 2 2 2 2 2 2 2 2 2 2 2 2 2 2 2 2 2 2
