X 2 2 2 2 2 2 2 2 2 2 2 2 2 2 2 2 2 2 2 0 2 2 2 2 2 2 2 2 2 2 2 2 2 2 2 2 2 2 X
2 X 2 2 2 2 2 2 3 3 3 3 3 3 2 2 2 2 2 2 2 2 2 2 2 2 3 3 3 3 3 3 2 2 2 2 2 2 X 2
2 2 X 2 2 2 2 3 3 3 3 3 3 3 3 2 2 2 2 2 2 2 2 2 2 3 3 3 3 3 3 3 3 2 2 2 2 X 2 2
2 2 2 X 2 2 3 3 1 1 1 1 1 1 3 3 2 2 2 2 2 2 2 2 3 3 1 1 1 1 1 1 3 3 2 2 X 2 2 2
2 2 2 2 X 2 3 1 1 1 1 1 1 1 1 3 2 2 2 2 2 2 2 2 3 1 1 1 1 1 1 1 1 3 2 X 2 2 2 2
2 2 2 2 2 X 3 1 1 1 1 1 1 1 1 1 3 2 2 2 2 2 2 2 3 1 1 1 1 1 1 1 1 1 3 X 2 2 2 2
2 2 2 3 3 3 X 1 X X X X X X 1 1 X 3 3 2 2 2 2 3 3 X 1 X X X X X X 1 1 X 3 3 2 2 
2 2 3 3 1 1 1 X 1 2 2 2 2 2 1 X 1 1 3 3 2 2 3 3 1 1 1 X 1 2 2 2 2 2 1 X 1 1 3 3 
2 2 3 1 1 1 1 1 X 2 3 3 3 2 X 1 1 1 1 3 2 2 3 1 1 1 1 1 X 2 3 3 3 2 X 1 1 1 1 3 
2 2 3 3 1 1 1 X 1 2 2 2 2 2 1 X 1 1 3 3 2 2 3 3 1 1 1 X 1 2 2 2 2 2 1 X 1 1 3 3 
2 2 2 3 3 3 X 1 X X X X X X 1 1 X 3 3 2 2 2 2 3 3 X 1 X X X X X X 1 1 X 3 3 2 2 
2 2 2 2 2 X 3 1 1 1 1 1 1 1 1 1 3 2 2 2 2 2 2 2 3 1 1 1 1 1 1 1 1 1 3 X 2 2 2 2
2 2 2 2 X 2 3 3 1 1 1 1 1 1 1 3 3 2 2 2 2 2 2 2 3 3 1 1 1 1 1 1 1 3 3 2 X 2 2 2
2 2 2 X 2 2 2 3 3 1 1 1 1 1 3 3 2 2 2 2 2 2 2 2 3 3 1 1 1 1 1 1 3 3 2 2 2 X 2 2
2 2 X 2 2 2 2 2 3 3 3 3 3 3 3 2 2 2 2 2 2 2 2 2 3 3 3 3 3 3 3 3 2 2 2 2 2 2 X 2
2 X 2 2 2 2 2 2 2 3 3 3 3 3 2 2 2 2 2 2 2 2 2 2 2 3 3 3 3 3 2 2 2 2 2 2 2 2 X 2
2 2 2 2 2 2 2 2 2 2 2 2 2 2 2 2 2 2 2 2 2 2 2 2 2 2 2 2 2 2 2 2 2 2 2 2 2 2 2 2
X 2 2 2 2 2 2 2 2 2 2 2 2 2 2 2 2 2 2 0 2 2 2 2 2 2 2 2 2 2 2 2 2 2 2 2 2 2 2 X
2 2 2 2 2 2 2 2 2 2 2 2 2 2 2 2 2 2 2 2 2 2 2 2 2 2 2 2 2 2 2 2 2 2 2 2 2 2 2 2
X 2 2 2 2 2 2 2 2 2 2 2 2 2 2 2 2 2 2 0 2 2 2 2 2 2 2 2 2 2 2 2 2 2 2 2 2 2 2 X