0 0 0 0 0 0 0 0 0 0 0 0 0 0 0 0 0 0 0 0 0 0 0 0 0 0 0 0 0 0
0 0 X X 1 1 1 1 1 1 1 1 1 1 1 1 1 1 1 1 1 1 1 1 1 1 X X 0 0
0 0 X 2 2 2 2 2 2 2 2 2 2 2 2 2 2 2 2 2 2 2 2 2 2 2 2 X 0 0
0 0 1 2 3 3 3 3 3 3 3 3 3 3 3 3 3 3 3 3 3 3 3 3 3 2 1 0 0 0
0 0 1 2 3 1 1 1 1 1 1 1 1 1 1 1 1 1 1 1 1 1 1 1 3 2 1 0 0 0
0 0 1 2 3 1 X X X X X X X X X X X X X X X X X 1 3 2 1 0 0 0
0 0 1 2 3 1 2 2 2 2 2 2 2 2 2 2 2 2 2 2 2 2 2 1 3 2 1 0 0 0
0 0 1 2 3 1 2 3 3 3 3 3 3 3 3 3 3 3 3 3 3 3 2 1 3 2 1 0 0 0
0 0 1 2 3 1 2 3 1 1 1 1 1 1 1 1 1 1 1 1 1 3 2 1 3 2 1 0 0 0
0 0 1 2 3 1 2 3 1 X X X X X X X X X X X 1 3 2 1 3 2 1 0 0 0
0 0 1 2 3 1 2 3 1 2 2 2 2 2 2 2 2 2 2 2 1 3 2 1 3 2 1 0 0 0
0 0 1 1 1 1 1 1 1 1 1 1 1 1 1 1 1 1 1 1 1 1 1 1 1 1 1 0 0 0
0 0 0 0 0 0 0 0 0 0 0 0 0 0 0 0 0 0 0 0 0 0 0 0 0 0 0 0 0 0
